#map

+------+------+------+------+------+------+------+------+------+------+------+------+------+------+------+------+
|  01  |  03  |  05  |  07  |  09  |  11  |  13  |  15  |  17  |  19  |  21  |  23  |  25  |  27  |  29  |  31  |
+------+------+------+------+------+------+------+------+------+------+------+------+------+------+------+------+
+------+------+------+------+------+------+------+------+------+------+------+------+------+------+------+------+------+
|  H1  |  H2  |  H3  |  H4  |  H5  |  H6  |  H7  |  H8  |  H9  |  HA  |  HB  |  HC  |  HD  |  HE  |  HF  |  HG  | EXIT 
+------+------+------+------+------+------+------+------+------+------+------+------+------+------+------+------+------+
+------+------+------+------+------+------+------+------+------+------+------+------+------+------+------+------+
|  02  |  04  |  06  |  08  |  10  |  12  |  14  |  16  |  18  |  20  |  22  |  24  |  26  |  28  |  30  |  32  |
+------+------+------+------+------+------+------+------+------+------+------+------+------+------+------+------+